vlastnosť = die Eigenschaft
vlastnosti = die Eigenschaften
nízký = niedrig
vysoký = hoch
chudý = dünn
tučný = dick
mladý = jung
starý = alt
čistý = sauber
špinavý = schmutzig
priateľský = freundlich
nepriateľský = feindlich
humorný = humorvoll
nudný = langweilig
sympatický = sympatisch
nesympatický = unsympatisch
šikovný = geschickt
nešikovný = ungeschickt
drzý = frech
úctivý = achtungsvoll
lakomý = geizig
štedrý = freigiebig
plachý = scheu
odvážny = mutig
skromný = bescheiden
chamtivý = habgierig
úprimný = offen
neúprimný = falsch
zvedavý = neugierig
bez záujmu = uninteressiert