rodina = die Familie
rodičia = die Eltern
starí rodičia = die Großeltern
otec = der Vater
otcovia = die Väter
starý otec = der Großvater
starí otcovia = die Großväter
mama = die Mutter
mamy = die Mütter
stará mama = die Großmutter
staré mamy = die Großmütter
dieťa = das Kind
deti = die Kinder
vnúčatá = die Enkelkinder
vnuk = der Enkel
vnuci = die Enkel
vnučka = die Enkelin
vnučky = die Enkelinnen
syn = der Sohn
synovia = die Söhne
dcéra = die Tochter
dcéry = die Töchter
súrodenec = das Geschwister
súrodenci = die Geschwister
brat = der Bruder
bratia = die Brüder
sestra = die Schwester
sestry = die Schwestern
teta = die Tante
tety = die Tanten
strýko = der Onkel
strýkovia = die Onkel