die Schulsachen = školské potreby
der Bleistift = ceruzka
die Bleistifte = ceruzky
der Füller = plniace pero
die Füller = plniace perá
der Kuli = guľôčkové pero
die Kulis = guľôčkové perá
der Spitzer = strúhadlo
die Spitzer = strúhadlá
der Radiergummi = guma
die Radiergummis = gumy
der Block = zápisník
die Blocks = zápisníky
der Taschenrechner = kalkulačka
die Taschenrechner = kalkulačky
der Malkasten = vodové farby
der Pinsel = štetec
die Pinsel = štetce
der Atlas = Atlas
die Atlasse = Atlasy
der Ordner = obal, šanón
die Ordner = obaly, šanóny
das Heft = zošit
die Häfte = zošity
das Buch = kniha
die Bücher = knihy
das Lineal = pravítko
die Lineale = pravítka
das Blatt = list (papier)
die Blätter = listy (papier)
das Mäppchen = peračník
die Mäppchen = peračníky
die Tasche = taška
die Taschen = tašky
die Schere = nožnice
die Tafel = tabuľa
die Tafeln = tabule
die Kreide = krieda
die Kreiden = kriedy
die Landkarte = mapa
die Landkarten = mapy
die Farbstifte = farebné ceruzky
die Filzstifte = fixky
die Sportsachen = športové potreby
die Turnschuhe = cvičky, tenisky